111111111111111111
11111111P0CE111111
111111111000011111
111111111111111111